1111111101111
1001000000000
1000011111001
1P0011E0000C1
1111101111111
