F 29,206,195
C 64,64,64

NO ./images/temple/Tileable2.png
SO ./images/temple/Tileable8.png
WE ./images/temple/Tileable9.png
EA ./images/temple/Tileable10.png

111111111111111111111111
100000000001000000000001
100000000000000000000001
100E00000001000000000001
100000100000000000000001
100000000001000000000001
100000000000010000000001
100000000000010000000001
100000000000010000000001
111111111111111111111111
100100000000010000000001
100100000000010000000001
100100000000010000000001
111111111111111111111111
100000000000000000000001
100000000000000000000001
100000000000000000000001
100000000000000000000001
100000000000000000000001
100000000000000000000001
100000000000000000000001
100000000000000000000001
111111111111111111111111
