F 29,206,195
C 64,64,64

NO ./images/new_wall1.png
SO ./images/new_wall2.png
WE ./images/new_wall3.png
EA ./images/new_wall4.png

1111111111111111111111111111111111111111111111111111111111111111
1000010000010000000000010000000000000000000000000000000000000001
1000010000010000000000010000000000000000000000000000000000000001
1000010000010000000000010000000000000000000000000000000000000001
1111111111111111111111110000000000000000000000000000000000000001
1000000000000100000000010000000000000000000000000000000S00000001
1000000000000100000000010000000000000000000000000000000000000001
1000000000000100000000010000000000000000000000100000000000000001
1111111111111111111111111111111111111111111111111111111111111111
1001000000000100000000010000000000000000000000100000000000000001
1001000000000100000000000000000000000000000000100000000000000001
1001000000000100000000010000000000000000000000100000000000000001
1111111111111111111111111111111111111111111111111111111111111111
1000000000000000000000010000000000000000000000100000000000000001
1000000000000000000000010000000000000000000000100000000000000001
1000000000000000000000010000000000000000000000100000000000000001
1000000000000000000000010000000000000000000000100000000000000001
1000000000000000000000000000000000000000000000100000000000000001
1000000000000000000000010000000000000000000000100000000000000001
1000000000000000000000010000000000000000000000100000000000000001
1000000000000000000000010000000000000000000000100000000000000001
1111111111111111111111111111111111111111111111111111111111111111
